                
                
SSSSSSSSCddSSSSS
SSSmmSSSSddSSSSS
SSSmmSjjSSSSSSSS
SSSSSSjjSSSSSDSo
aaaaaaaaaaaaaaaF
aaaaaaaaaaaaaaaF
NNNNmmNNNNNNNDNo
NNNNmmNNNNNNNNNN
NNNNNNNNjjNjjNNN
NNNNNNNNjjNjjNNN
