                
                
                
FSSSooSSSSSSSSSS
FSSSooSSCSSSSSSS
FSSSSSSSTTTSSSSS
FSSSSSSSTETSSSSS
pppppppppppppppp
FNNLNNNNNiiNNNNN
FNNLCNNNNiNNNNNN
FNNLNNNNNNNggNNN
FNNNNNNNNNNggNNN
