                
                
                
FSSSSSSSSSSSSSSS
FSSSSSSSSSCSSSSS
FSSSSSSSSSSSSSSS
FSSSSSSSSSSSSSSS
pppppppppppppppp
FNNLNNNNNiiNNNNN
FNNLCNNNNiiNNNNN
FNNLNNNNNNNggNNN
FNNLNNNNNNNggNNN
