                
                
SSSSSSSSCddSSSSS
SSSmmSSSSddSSSSS
SSSmmSjjSSSSSSSS
SSSSSSjjSSSSSDSo
aaaaaaaaaaaaaaao
aaaaaaaaaaaaaaao
NNNNmmNNNNNNNDNo
NNNNmmNNNNNNNNNN
NNNNNNNNjjNjjNNN
NNNNNNNNjjNjjNNN
