                
                
SSSSSSSSCddSSSSS
SSSmmSSSSddSSSSS
SSSmmSjjSSSSSSSS
SSSSSSjjSSSSSDSS
aaaaaaaaaaaaaaaF
aaaaaaaaaaaaaaaF
NNNNmmNNNNNNNDNN
NNNNmmNNNNNNNNNN
NNNNNNNNjjNjjNNN
NNNNNNNNjjNjjNNN
