                
                
                
FSSSooSSSSTSSSSS
FSSSooSSSETSSSSS
FSSSSSSSSSTSSSSS
FSSSSSSSSSTSSSSS
pppppppppppppppp
FNNLNNNNNiiNNNNN
FNNLNNNNNiCNNNNN
FNNLNNNNNNNggNNN
FNNNNNNNNNNggNNN
