                
                
ASSSSSSSCddSSSSS
SSSmmSSSSddSSSSS
SSSmmSjjSSSSSSSS
SSSSSSjjSSSSSDSo
aaaaaaaaaaaaaaaF
aaaaaaaaaaaaaaaF
NNNNmmNNNNNNNDNo
NNNNmmNNNNNNNNNN
NNNNNNNNjjNjjNNN
BNNNNNNNjjNjjNNN
