                
                
                
FSSSooSSSSSSSSSS
FSSSooSSCSSSSSSS
FSSSSSSSSSSSSSSS
FSSSSSSSSSSSSSSS
pppppppppppppppp
FNNLNNNNNiiNNNNN
FNNLCNNNNiNNNNNN
FNNLNNNNNNNggNNN
FNNNNNNNNNNggNNN