                
                
                
SSSStSSSSLLLLLLL
SSCStSSSSLLLLLLL
SSSStSSSSLLLLLLL
SSSStSSSDLLLFFFF
gggggggggLLLFFFF
NNNmNNNNDLLLLLLL
NNNmNNNNNLLLLLLL
NNNmNhhNNLLLLLLL
NNNNNhhNNLLLLLLL
