                
                
                
SSSStSSSSLLLLLLL
SSCStSSSSLLLLLLL
SSSStSSSSLLLLLLL
SSSStSSSDLLLuuuF
gggggggggLLLuuuF
NNNmNNNNDLLLLLLL
NNNmNNNNNLLLLLLL
NNNmNhhNNLLLLLLL
NNNNNhhNNLLLLLLL
