                
                
                
SSSStSSSSLLLLLLL
SSCStSSSSLLLLLLL
SSSStSSSSLLLLLLL
SSSStSSSDLLLoFFF
gggggggggLLLoFFF
NNNmNNNNDLLLLLLL
NNNmNNNNNLLLLLLL
NNNmNhhNNLLLLLLL
NNNNNhhNNLLLLLLL
