                
                
                
SSSStSSSSLLLLLLL
SSCStSSSSLLLLLLL
SSSStSSSSLLLLLLL
SSSStSSSDLLLoooF
gggggggggLLLoooF
NNNmNNNNDLLLLLLL
NNNmNNNNNLLLLLLL
NNNmNhhNNLLLLLLL
NNNNNhhNNLLLLLLL
